150
17
0  0  0  0  0  0  0  0  0  0  0  0  0  0  0  0  0  0  0  0  0  0  0  0  0  0  0  0  0  0  0  0  0  0  0  0  0  0  0  0  0  0  0  0  0  0  0  0  0  0  0  0  0  0  0  0  0  0  0  0  0  0  0  0  0  23 24 24 24 24 24 24 24 24 24 24 24 24 24 24 24 24 24 24 24 24 24 24 24 24 24 24 24 24 24 24 24 24 24 24 24 24 24 24 24 24 24 24 24 24 24 24 24 24 24 24 24 24 24 24 24 24 24 24 24 24 24 24 24 24 24 24 24 24 24 24 24 24 24 24 24 24 24 24 24 24 24 24 24 24
0  0  0  0  0  0  0  0  0  0  0  0  0  0  0  0  0  0  0  0  0  0  0  0  0  0  0  0  0  0  0  0  0  0  0  0  0  0  0  0  0  0  0  0  0  0  0  0  0  0  0  0  0  0  0  0  0  0  0  0  0  0  0  0  0  23 24 24 24 24 24 24 24 24 24 24 24 24 24 24 24 24 24 24 24 24 24 24 24 24 24 24 24 24 24 24 24 24 24 24 24 24 24 24 24 24 24 24 24 24 24 24 24 24 24 24 24 24 24 24 24 24 24 24 24 24 24 24 24 24 24 24 24 24 24 24 24 24 24 24 24 24 24 24 24 24 24 24 24 24
0  0  0  0  0  0  0  0  0  0  0  0  0  0  0  0  0  0  0  0  0  0  0  0  0  0  0  0  0  0  0  0  0  0  0  0  0  0  0  0  0  0  0  0  0  0  0  0  0  0  0  10 0  0  0  0  0  0  0  0  0  0  0  0  0  31 28 28 28 24 24 24 24 24 24 24 24 24 24 24 24 24 24 24 24 24 24 24 24 24 24 24 24 24 24 24 24 24 24 24 24 24 24 24 24 24 24 24 24 24 24 24 24 24 24 24 24 24 24 24 24 24 24 24 24 24 24 24 24 24 24 24 24 24 24 24 24 24 24 24 24 24 24 24 24 24 24 24 24 24
0  1  2  10 0  0  0  0  0  0  0  0  0  0  0  0  0  0  0  0  0  0  0  0  0  0  0  0  0  10 0  0  0  0  10 0  0  0  0  0  0  11 0  0  0  5  0  0  0  0  33 34 35 0  0  0  0  0  10 0  0  0  0  0  0  0  0  5  0  23 24 24 24 24 24 24 24 24 24 24 24 24 24 24 24 24 24 24 24 24 24 24 24 24 24 24 24 24 24 24 24 24 24 24 24 24 24 24 24 24 24 24 24 24 24 24 24 24 24 24 24 24 24 24 24 24 24 24 24 24 24 24 24 24 24 24 24 24 24 24 24 24 24 24 24 24 24 24 24 24
21 21 21 22 0  0  0  0  0  0  0  0  0  0  0  0  0  0  0  0  0  0  0  0  0  0  0  0  33 34 35 0  0  33 34 35 0  0  33 35 20 21 21 21 21 22 0  0  0  0  0  0  0  0  0  0  20 21 21 21 21 21 21 21 21 21 21 22 0  31 28 28 24 24 24 24 24 24 24 24 24 24 24 24 24 24 24 24 24 24 24 24 24 24 24 24 24 24 24 24 24 24 24 24 24 24 24 24 24 24 24 24 24 24 28 28 28 28 28 28 28 28 28 28 28 28 28 28 28 28 28 28 28 28 28 28 28 28 28 28 28 28 28 28 28 28 28 28 24 24
24 24 24 25 0  0  0  0  0  0  0  0  0  0  0  0  0  0  0  38 0  0  0  0  0  0  0  0  0  0  0  0  0  0  0  0  0  0  0  0  23 24 28 28 24 25 6  7  17 6  7  6  7  17 6  7  23 24 24 24 24 24 24 24 24 24 24 25 0  0  0  0  23 24 24 24 24 24 24 24 24 24 24 24 24 24 24 24 24 24 24 24 24 24 24 24 24 24 24 24 24 24 24 24 24 24 24 24 24 24 24 24 24 25 0  0  0  0  0  0  0  0  0  0  0  0  0  0  0  0  0  0  0  0  0  0  0  0  0  0  0  0  0  0  0  0  0  0  23 24
24 24 24 25 0  0  0  0  0  0  0  0  0  0  0  0  0  0  0  33 34 34 34 34 34 34 35 0  0  0  0  0  0  0  0  0  0  0  0  0  23 25 0  0  23 29 30 21 21 21 21 21 21 21 21 26 27 24 24 24 24 24 24 24 24 24 24 29 30 21 22 0  31 28 28 28 28 28 28 28 28 24 24 24 28 28 28 28 28 28 28 28 28 28 28 24 24 24 28 28 28 28 28 28 28 28 28 28 28 28 28 28 28 32 0  0  0  0  0  0  0  0  0  0  0  0  0  0  0  0  0  0  0  0  0  0  0  0  0  0  0  0  0  0  0  0  0  0  23 24
24 24 24 25 0  0  0  0  0  0  0  0  0  0  0  0  0  0  0  0  0  0  0  0  0  0  0  0  0  0  0  0  0  0  0  0  0  0  0  0  23 32 0  0  31 24 24 24 24 24 24 24 24 24 24 24 24 24 24 24 24 24 24 24 24 24 24 24 24 24 25 0  0  0  0  0  0  0  0  0  0  23 24 25 0  0  0  0  0  0  0  0  0  0  0  28 24 28 0  0  0  0  0  0  0  0  0  0  0  0  0  0  0  0  0  0  0  0  0  0  0  0  0  0  0  0  0  0  0  0  0  0  0  0  0  0  0  0  0  0  0  0  0  0  0  0  0  0  23 24
24 24 24 25 0  0  0  0  0  0  0  0  0  0  0  0  0  0  0  0  0  0  0  0  0  0  0  0  33 34 34 34 34 34 34 35 0  0  0  0  23 0  0  0  0  31 28 28 28 28 28 28 28 28 28 28 28 28 28 28 28 28 28 28 28 28 28 28 28 24 29 30 21 21 21 22 0  0  0  0  0  31 28 32 0  0  0  0  0  0  0  0  0  0  0  0  28 0  0  0  10 0  6  7  0  0  0  0  0  0  0  0  0  0  0  0  0  0  0  0  0  10 0  0  0  0  0  11 38 0  0  0  0  0  0  0  0  0  0  0  0  0  0  0  0  0  0  0  23 24
24 24 24 25 0  0  0  0  0  0  0  0  0  0  0  0  0  0  0  0  0  0  0  0  0  0  0  0  0  0  0  0  0  0  0  0  0  0  0  38 23 0  20 22 0  0  0  0  0  0  0  0  0  0  0  0  0  0  0  0  0  0  0  0  0  0  0  0  0  31 28 28 28 28 28 32 0  0  0  0  0  0  0  0  0  0  0  0  0  0  0  0  0  0  0  0  10 0  0  20 21 21 21 21 22 0  0  33 35 0  0  33 35 0  0  33 35 0  0  20 21 21 21 21 21 21 21 21 22 0  0  0  0  0  0  0  0  0  0  0  0  0  0  0  0  0  0  0  23 24
24 24 24 25 0  0  0  0  0  0  0  0  0  0  0  0  0  0  0  0  0  0  0  0  0  0  0  0  0  0  0  0  0  0  0  0  0  33 34 34 23 0  23 29 30 22 0  0  6  7  0  6  7  0  8  0  8  0  0  6  7  0  0  0  6  7  0  0  0  0  0  0  0  0  0  0  0  0  0  0  0  0  3  4  0  0  0  3  4  0  0  11 0  38 0  33 34 35 0  23 24 24 24 24 25 0  0  0  0  0  0  0  0  0  0  0  0  0  0  23 24 24 24 28 28 28 28 28 32 0  0  0  0  0  0  0  0  0  0  0  0  0  0  0  0  0  0  0  23 24
24 24 24 25 0  0  0  0  0  0  0  0  0  0  0  0  0  0  0  0  0  0  0  0  0  0  0  0  0  0  0  6  7  8  6  7  8  6  7  8  23 0  23 24 24 29 30 21 21 21 21 21 21 21 21 21 21 21 21 21 21 21 21 21 21 21 21 21 21 21 21 21 21 21 21 21 21 21 21 37 37 37 37 37 37 37 37 37 37 37 37 21 21 22 0  0  0  0  0  23 24 24 24 24 25 0  0  0  0  0  0  0  0  0  0  0  0  0  0  23 24 24 25 0  0  0  0  0  0  0  0  0  0  0  0  0  0  0  0  0  0  0  0  0  0  0  0  0  23 24
24 24 24 25 0  0  0  0  0  0  0  0  0  0  0  0  0  0  0  0  0  0  0  0  0  0  0  0  0  0  20 21 21 21 21 21 21 21 21 26 27 0  23 24 24 24 24 24 24 24 24 24 24 24 24 24 24 24 24 24 24 24 24 24 24 24 24 24 24 24 24 24 24 24 24 24 24 24 24 41 41 41 41 41 41 41 41 41 41 41 41 24 24 25 40 40 40 40 40 23 24 24 24 24 25 40 40 40 40 40 40 40 40 40 40 40 40 40 40 23 24 24 25 0  0  0  0  0  0  0  0  0  0  0  0  0  0  0  0  0  0  0  0  0  0  0  0  0  23 24
24 24 24 25 0  0  0  0  0  0  0  0  0  0  0  0  0  10 0  0  3  4  0  0  0  0  3  4  0  0  23 24 24 24 24 24 24 24 24 24 24 0  23 24 24 24 24 24 24 24 24 24 24 24 24 24 24 24 24 24 24 24 24 24 24 24 24 24 24 24 24 24 24 24 24 24 24 24 24 41 41 41 41 41 41 41 41 41 41 41 41 24 24 25 41 41 41 41 41 23 24 24 24 24 25 41 41 41 41 41 41 41 41 41 41 41 41 41 41 23 24 24 29 30 21 21 21 21 21 12 12 12 12 12 12 12 12 12 12 12 12 12 12 12 12 12 12 12 23 24
24 24 24 25 0  0  0  0  0  0  0  0  0  0  20 21 21 21 21 37 37 37 37 37 37 37 37 37 37 26 27 24 24 24 24 24 24 24 24 24 24 0  23 24 24 24 24 24 24 24 24 24 24 24 24 24 24 24 24 24 24 24 24 24 24 24 24 24 24 24 24 24 24 24 24 24 24 24 24 41 41 41 41 41 41 41 41 41 41 41 41 24 24 25 41 41 41 41 41 23 24 24 24 24 25 41 41 41 41 41 41 41 41 41 41 41 41 41 41 23 24 24 24 24 24 24 24 24 29 39 39 39 39 39 39 39 39 39 39 39 39 39 39 39 39 39 39 39 27 24
24 24 24 25 40 40 40 40 40 40 40 40 40 40 23 24 24 24 24 41 41 41 41 41 41 41 41 41 41 24 24 24 24 24 24 24 24 24 24 24 24 40 23 24 24 24 24 24 24 24 24 24 24 24 24 24 24 24 24 24 24 24 24 24 24 24 24 24 24 24 24 24 24 24 24 24 24 24 24 41 41 41 41 41 41 41 41 41 41 41 41 24 24 25 41 41 41 41 41 23 24 24 24 24 25 41 41 41 41 41 41 41 41 41 41 41 41 41 41 23 24 24 24 24 24 24 24 24 24 24 24 24 24 24 24 24 24 24 24 24 24 24 24 24 24 24 24 24 24 24
24 24 24 25 41 41 41 41 41 41 41 41 41 41 23 24 24 24 24 41 41 41 41 41 41 41 41 41 41 24 24 24 24 24 24 24 24 24 24 24 24 41 23 24 24 24 24 24 24 24 24 24 24 24 24 24 24 24 24 24 24 24 24 24 24 24 24 24 24 24 24 24 24 24 24 24 24 24 24 41 41 41 41 41 41 41 41 41 41 41 41 24 24 25 41 41 41 41 41 23 24 24 24 24 25 41 41 41 41 41 41 41 41 41 41 41 41 41 41 23 24 24 24 24 24 24 24 24 24 24 24 24 24 24 24 24 24 24 24 24 24 24 24 24 24 24 24 24 24 24
