120
12
37 24 24 24 24 25 0  0  0  0  0  0  0  0  0  0  0  0  0  0  0  0  0  0  0  0  0  0  0  0  0  0  0  0  0  0  0  0  0  0  0  0  0  0  0  0  0  0  0  0  0  0  0  0  0  0  0  0  0  0  0  0  0  0  0  0  0  0  0  0  0  0  0  0  0  0  0  0  0  0  0  0  0  0  0  0  23 24 24 24 24 24 24 24 24 24 24 24 24 24 24 24 24 24 24 24 24 24 24 24 24 24 24 24 24 24 24 24 24 24 
37 28 28 28 28 32 0  0  0  0  0  0  0  0  0  0  0  0  0  0  0  0  0  0  7  16 7  0  0  0  0  0  0  0  0  0  0  0  0  0  0  0  0  0  0  0  0  0  0  0  0  0  0  0  0  0  0  0  0  0  0  0  0  0  0  0  0  0  0  0  0  0  0  0  0  0  0  0  0  0  0  0  0  0  0  0  23 24 24 24 24 24 24 24 24 24 24 24 24 24 24 24 28 28 28 28 28 28 28 28 28 28 28 28 28 28 28 24 24 24 
37 0  0  0  0  0  0  0  0  0  0  0  0  0  0  0  0  0  0  0  0  0  0  0  33 34 34 34 34 34 34 35 0  0  0  0  0  0  0  0  8  8  5  0  0  0  8  0  0  0  8  8  8  8  0  0  0  0  0  0  0  0  0  0  0  0  0  0  0  0  0  0  0  0  21 0  10 21 0  0  19 0  0  0  0  0  23 24 24 24 24 24 24 24 24 24 24 24 24 24 24 25 0  0  0  0  0  0  0  0  0  0  0  0  0  0  0  23 24 24 
37 5  11 13 14 15 0  0  0  0  0  13 14 15 0  0  0  0  0  0  0  0  0  0  0  0  0  0  0  0  0  0  0  0  0  0  0  0  0  20 21 21 21 21 21 21 21 21 21 21 21 21 21 21 21 21 22 0  0  0  0  0  0  0  0  0  0  0  0  0  0  0  20 21 24 21 21 24 21 21 22 0  0  0  0  0  23 24 24 24 24 24 24 24 24 24 24 24 24 24 24 25 0  0  0  0  0  0  33 34 34 34 34 34 34 34 34 23 24 24 
37 33 34 34 34 35 0  0  0  0  0  33 34 35 0  0  0  0  0  0  0  0  34 0  0  0  0  0  0  0  0  0  0  0  20 21 22 0  0  31 28 28 28 28 24 24 24 24 24 24 24 24 24 24 24 24 25 0  0  13 14 15 0  0  0  0  0  0  0  0  12 36 23 24 24 24 24 24 24 24 25 0  0  0  0  0  23 24 24 24 24 24 24 24 24 24 24 24 24 24 24 25 0  0  0  0  0  0  0  0  0  0  0  0  0  0  0  23 24 24 
37 0  0  0  0  0  0  13 14 15 0  0  0  0  18 5  6  19 6  6  6  0  0  0  0  0  0  0  0  0  0  0  16 36 23 24 25 0  0  0  0  0  0  0  23 24 24 24 24 24 24 24 24 24 24 24 25 0  0  33 34 35 0  0  0  0  0  0  0  20 21 26 27 24 24 24 24 24 24 24 25 0  0  0  0  0  31 28 24 24 24 24 24 24 24 28 28 28 28 28 28 32 0  33 34 34 35 0  0  0  0  0  0  0  0  0  0  23 24 24 
37 0  0  0  0  0  0  33 34 35 0  0  0  0  20 21 21 21 21 21 22 0  0  0  0  0  0  0  0  0  20 21 21 26 27 24 25 36 17 17 17 17 0  0  31 28 28 28 28 28 28 28 24 24 24 24 25 0  0  0  0  0  0  0  0  10 0  0  16 23 24 24 24 24 24 24 24 24 24 24 25 0  0  0  0  0  0  0  28 24 24 24 24 24 28 0  0  0  0  0  0  0  0  0  0  0  0  0  0  0  0  0  0  0  0  0  0  23 24 24 
37 6  6  6  6  6  0  0  0  0  0  0  0  16 23 24 24 24 24 24 25 16 13 14 15 10 19 0  34 0  23 24 24 24 24 24 29 30 21 21 21 22 0  0  0  0  0  0  0  0  0  0  23 24 24 24 25 0  0  0  0  0  0  0  20 21 21 21 26 27 24 24 24 24 24 24 24 24 24 24 25 0  0  0  0  0  0  0  0  28 24 24 24 28 0  0  0  0  0  0  0  0  0  0  0  0  0  0  33 34 34 35 0  0  0  0  0  23 24 24 
37 20 21 21 21 22 0  0  0  0  0  0  0  36 23 24 24 24 24 24 29 30 21 21 21 21 22 0  0  0  23 24 24 24 24 24 24 24 24 24 24 25 0  0  0  0  0  0  0  0  0  0  23 24 24 24 25 0  0  0  0  0  0  0  23 24 24 24 24 24 28 28 28 28 28 28 28 28 28 28 32 0  0  0  0  0  0  0  0  0  28 24 28 0  0  0  0  0  0  0  0  0  0  0  0  0  0  0  0  0  0  0  0  0  0  0  0  23 24 24 
37 23 24 24 24 25 0  0  0  0  10 12 36 36 23 24 24 24 24 24 24 24 24 24 24 24 25 0  0  0  23 24 24 24 24 24 24 24 24 24 24 25 36 17 17 17 17 17 17 17 17 17 23 24 24 24 25 0  0  0  0  0  0  0  23 24 24 24 24 25 0  0  0  0  0  0  0  0  0  0  0  0  0  0  0  0  0  0  0  0  0  28 0  0  0  0  0  0  0  0  0  0  0  0  0  0  0  0  0  0  0  0  0  33 34 34 34 23 24 24 
37 23 24 24 24 25 0  0  0  20 21 21 21 26 27 24 24 24 24 24 24 24 24 24 24 24 25 0  0  0  23 24 24 24 24 24 24 24 24 24 24 29 30 21 21 21 21 21 21 21 21 26 27 24 24 24 25 0  0  0  0  0  0  0  23 24 24 24 24 25 0  0  17 17 17 17 0  0  0  0  0  0  17 17 17 0  0  0  0  0  0  0  0  0  0  17 17 17 17 0  0  0  0  17 17 17 17 0  0  0  0  0  0  17 17 17 17 23 24 24 
37 23 24 24 24 25 40 40 40 23 24 24 24 24 24 24 24 24 24 24 24 24 24 24 24 24 25 40 40 40 23 24 24 24 24 24 24 24 24 24 24 24 24 24 24 24 24 24 24 24 24 24 24 24 24 24 25 40 40 40 40 40 40 40 23 24 24 24 24 29 30 21 21 21 21 21 21 21 21 21 21 21 21 21 21 21 21 21 21 21 21 21 21 21 21 21 21 21 21 21 21 21 21 21 21 21 21 21 21 21 21 21 21 21 21 21 26 27 24 24 
