40 40
32 32 32 32 32 32 32 32 32 32 33 33 33 33 33 33 33 33 33 33 33 33 33 33 33 34 34 34 34 34 34 34 34 34 34 34 34 34 34 34 
32  0  0  0  0  0  0  0  0  0  0  0  0  0  0  0  0  0  0  0 19 15  0  0  0 33 34 33 34 34 34 34 34 34 34 34 34 34 34 34
32  0  0  0  0  0  0  0  0  0  0  0  0  0  0  0  0  0  0  0 19 15  0  0  0  0 36  0 33 34 34 34 34 34 34 34 34 34 34 34
32  0  4  0  0  0  0  0  0  0  0  0  0  0  0  0  0  0  0  0 19 15  0  0  0  0  0  0  0 33 36 36 33 33 35 33 33 36 33 33
32  0  5  0  0  0  0  0  0  0  0  0  0  0  0  0  0  0  0  0 19 15  0  0  0  0  0  0  0  0  0  0  0  0  5  0  0  0  0 32
32  0  5  0  0  0  0  0  0  0  0  0  0  0  0  0  0  0  0  0 19 11  6  6  6  6  6  6  6  6  6  6  6  6 17  6  6  9  0 32
32  0  5  0  0  0  0  0  0  0  0  0  0  0  0  0  0  0  0  0 19 15  0  0  0  0  0  0  0  0  0  0  0  0  0  0  0  5  0 32
32  0  5  0  0  0  0  0  0  0  0  0  0  0  0  0  0  0  0  0 19 15  0  0  0  0  0  0  0  0  0  0  0  0  0  0  0  5  0 32
32  0  5  0  0  0  0  0  0  0  0  0  0  0  0  0  0  0  0  0 19 15  0  0  0  0  0  0  0  0  0  0  0  0  0  0  0  5  0 32
32  0  5  0  0  0  0  0  0  0  0  0  0  0  0  0  0  0  0  0 19 15  0  0  0  0  0  0  0  0  0  0  0  0  0  0  0  5  0 32
32  0  5  0  0  0  0  0  0  0  0  0  0  0  0  0  0  0  0  0 19 15  0  0  0  0  0  0  0  0  0  0  0  0  0  0  0  5  0 32
32  0  5  0  0  0  0  0  0  0  0  0  0  0  0  0  0  0  0  0 19 15  0  0  0  0  0  0  0  0  0  0  0  0  0  0  0  5  0 32
32  0  5  0  0  0  0  0  0  0  0  0  0  0  0  0  0  0  0  0 19 15  0  0  0  0  0  0  0  0  0  0  0  0  0  0  0  5  0 32
32  0  5  0  0  0  0  0  0  0  0  0  0  0  0  0  0  0  0 12 11 11 14  0  0  0  0  0  0  0  0  0  0  0  0  0  0  5  0 32
32  0 19 13 13 13 13 13 13 13 13 13 13 13 13 13 13 13 13 11 11 11 11 13 13 13 13 13 13 13 13 13 13 13 13 13 13 15  0 32
32  0 19 17 17 17 17 17 17 17 17 17 17 17 17 17 17 17 17 11 11 11 11 17 17 17 17 17 17 17 17 17 17 17 17 17 17 15  0 32
32  0  5  0  0  0  0  0  0  0  0  0  0  0  0  0  0  0  0 18 11 11 16  0  0  0  0  0  0  0  0  0  0  0  0  0  0  5  0 32
32  0  5  0  0  0  0  0  0  0  0  0  0  0  0  0  0  0  0  0 19 15  0  0  0  0  0  0  0  0  0  0  0  0  0  0  0  5  0 32
32  0  5  0  0  0  0  0  0  0  0  0  0  0  0  0  0  0  0  0 19 15  0  0  0  0  0  0  0  0  0  0  0  0  0  0  0  5  0 32
32  0  5  0  0  0  0  0  0  0  0  0  0  0  0  0  0  0  0  0 19 15  0  0  0 12 13 13 13 13 14  0  0  0  0  0  0  5  0 32
32  0  5  0  0  0  0  0  0  0  0  0  0  0  0  0  0  0  0  0 19 15  0  0  0 19 11 11 11 11 15  0  0  0  0  0  0  5  0 32
32  0  5  0  0  0  0  0  0  0  0  0  0  0  0  0  0  0  0  0 19 15  0  0  0 19 11 11 11 11 15  0  0  0  0  0  0  5  0 32
32  0  5  0  0  0  0  0  0  0  0  0  0  0  0  0  0  0  0  0 19 15  0  0  0 19 11 11 11 11 15  0  0  0  0  0  0  5  0 32
32  0  5  0  0  0  0  0  0  0  0  0  0  0  0  0  0  0  0  0 19 15  0  0  0 19 11 11 11 11 15  0  0  0  0  0  0  5  0 32
32  0  5  0  0  0  0  0  0  0  0  0  0  0  0  0  0  0  0  0 19 15  0  0  0 18 17 17 17 17 16  0  0  0  0  0  0  5  0 32
32  0  5  0  0  0  0  0  0  0  0  0  0  0  0  0  0  0  0  0 19 15  0  0  0  0  0  0  0  0  0  0  0  0  0  0  0  5  0 32
32  0  5  0  0  0  0  0  0  0  0  0  0  0  0  0  0  0  0  0 19 15  0  0  0  0  0  0  0  0  0  0  0  0  0  0  0  5  0 32
32  0  5  0  0  0  0  0  0  0  0  0  0  0  0  0  0  0  0  0 19 15  0  0  0  0  0  0  0  0  0  0  0  0  0  0  0  5  0 32
32  0  5  0  0  0  0  0  0  0  0  0  0  0  0  0  0  0  0  0 19 15  0  0  0  0  0  0  0  0  0  0  0  0  0  0  0  5  0 32
32  0  7  6  6  6  6  6 13  6  6  6  6  6  6  6  6  6  6  6 11 11  6  6  6  6  6  6  6  6  6  6  6  6  6 13  6 10  0 32
32  0  0  0  0  0  0  0  5  0  0  0  0  0  0  0  0  0  0  0 19 15  0  0  0  0  0  0  0  0  0  0  0  0  0  5  0  0  0 32
32  0  0  0  0  0  0  0  5  0  0  0  0  0  0  0  0  0  0  0 19 15  0  0  0  0  0  0  0  0  0  0  0  0  0  5  0  0  0 32
32  0  0  0  0  0  0  0  5  0  0  0  0  0  0  0  0  0  0  0 19 15  0  0  0  0  0  0  0  0  0  0  0  0  0  5  0  0  0 32
32  0  0  0  0  0  0  0  5  0  0  0  0  0  0  0  0  0  0  0 19 15  0  0  0  0  0  0  0  0  0  0  0  0  0  5  0  0  0 32
13 13 13 13 13 13 13 13 11 13 13 13 13 13 13 13 13 13 13 13 11 11 13 13 13 13 13 13 13 13 13 13 13 13 13 11 13 13 13 13
22 23 22 23 22 23 22 22 24 22 22 22 22 22 22 22 22 22 22 22 24 24 22 22 22 22 22 22 22 22 22 22 22 22 22 24 22 22 22 22
26 26 26 26 26 26 26 28 24 27 26 26 26 26 26 26 26 26 26 27 24 24 28 26 26 26 26 26 26 26 26 26 26 26 27 24 28 26 26 26
26 26 26 26 26 26 26 28 25 27 26 26 26 26 26 26 26 26 26 28 25 25 27 26 26 26 26 26 26 26 26 26 26 26 28 25 27 26 26 26
30 30 30 30 30 30 30 30 30 30 30 30 30 30 30 30 30 30 30 30 30 30 30 30 30 30 30 30 30 30 30 30 30 30 30 30 30 30 30 30
31 31 31 31 31 31 31 31 31 31 31 31 31 31 31 31 31 31 31 31 31 31 31 31 31 31 31 31 31 31 31 31 31 31 31 31 31 31 31 31